filename, language, JSON, JavaScript, comment, blank, total
d:\nikola\Programming\DevConnect\DevConnect\config\db.js, JavaScript, 0, 18, 0, 3, 21
d:\nikola\Programming\DevConnect\DevConnect\config\default.json, JSON, 6, 0, 0, 1, 7
d:\nikola\Programming\DevConnect\DevConnect\middleware\auth.js, JavaScript, 0, 16, 0, 8, 24
d:\nikola\Programming\DevConnect\DevConnect\model\Post.js, JavaScript, 0, 52, 0, 2, 54
d:\nikola\Programming\DevConnect\DevConnect\model\Profile.js, JavaScript, 0, 111, 0, 4, 115
d:\nikola\Programming\DevConnect\DevConnect\model\User.js, JavaScript, 0, 24, 0, 2, 26
d:\nikola\Programming\DevConnect\DevConnect\package-lock.json, JSON, 2497, 0, 0, 1, 2498
d:\nikola\Programming\DevConnect\DevConnect\package.json, JSON, 34, 0, 0, 1, 35
d:\nikola\Programming\DevConnect\DevConnect\routes\api\auth.js, JavaScript, 0, 50, 4, 8, 62
d:\nikola\Programming\DevConnect\DevConnect\routes\api\posts.js, JavaScript, 0, 145, 10, 24, 179
d:\nikola\Programming\DevConnect\DevConnect\routes\api\profiles.js, JavaScript, 0, 257, 21, 27, 305
d:\nikola\Programming\DevConnect\DevConnect\routes\api\users.js, JavaScript, 0, 72, 9, 11, 92
d:\nikola\Programming\DevConnect\DevConnect\server.js, JavaScript, 0, 11, 0, 3, 14
Total, -, 2537, 756, 44, 95, 3432